N:422
T:240
S:21,17
D:0,0,0,0,0,0,0,0,0,0,0,0,0,0,0,0,0,0,3,0,0
D:0,0,0,0,0,2,2,0,2,2,2,2,0,0,0,0,0,0,3,0,0
D:0,0,0,0,0,0,3,0,0,3,3,3,2,0,0,0,0,0,3,0,0
D:0,0,0,0,0,2,2,0,2,2,2,2,0,0,0,0,0,2,3,2,0
D:0,2,0,2,0,0,0,0,0,0,0,0,0,0,0,3,3,3,2,3,0
D:0,2,0,2,0,3,3,3,0,0,0,0,2,2,0,0,0,2,3,2,0
D:0,2,0,2,0,3,3,3,0,0,0,0,0,3,2,0,0,0,3,0,0
D:0,0,0,0,0,3,3,3,0,2,0,2,0,0,0,0,0,0,0,0,0
D:0,2,2,2,0,0,0,0,0,0,3,0,0,0,0,0,0,2,2,2,0
D:0,0,0,0,0,0,0,0,0,2,0,2,0,3,3,3,0,0,0,0,0
D:0,0,3,0,0,0,2,3,0,0,0,0,0,3,3,3,0,2,0,2,0
D:0,2,3,2,0,0,0,2,2,0,0,0,0,3,3,3,0,2,0,2,0
D:0,3,2,3,3,3,0,0,0,0,0,0,0,0,0,0,0,2,0,2,0
D:0,2,3,2,0,0,0,0,0,2,2,2,2,0,2,2,0,0,0,0,0
D:0,0,3,0,0,0,0,0,2,3,3,3,0,0,3,0,0,0,0,0,0
D:0,0,3,0,0,0,0,0,0,2,2,2,2,0,2,2,0,0,0,0,0
D:0,0,3,0,0,0,0,0,0,0,0,0,0,0,0,0,0,0,0,0,0
C:2,2
H:18,14
