N:bcn01
T:100
S:15,17
D:0,0,0,0,0,0,0,0,0,0,0,0,0,0,0
D:0,3,3,3,0,0,3,3,3,0,3,0,0,0,3
D:0,3,0,3,0,0,3,0,0,0,3,3,0,0,3
D:0,3,3,3,3,0,3,0,0,0,3,0,3,0,3
D:0,3,0,0,3,0,3,0,0,0,3,0,0,3,3
D:0,3,3,3,3,0,3,3,3,0,3,0,0,0,3
D:0,0,0,0,0,0,0,0,0,0,0,0,0,0,0
D:0,3,0,0,0,3,0,0,0,0,0,3,0,0,0
D:2,0,2,0,2,0,0,2,0,0,2,0,2,0,2
D:0,0,0,3,0,0,0,0,0,3,0,0,0,3,0
D:0,0,0,0,0,0,0,0,0,0,0,0,0,0,0
D:3,0,0,0,3,0,3,3,3,0,3,3,3,3,0
D:3,3,0,0,3,0,0,0,3,0,3,0,0,3,0
D:3,0,3,0,3,0,0,0,3,0,3,3,3,3,0
D:3,0,0,3,3,0,0,0,3,0,0,3,0,3,0
D:3,0,0,0,3,0,3,3,3,0,0,3,3,3,0
D:0,0,0,0,0,0,0,0,0,0,0,0,0,0,0
C:6,8
H:8,8
