N:bcn03
T:150
S:15,17
D:0,0,0,0,0,0,0,0,0,0,0,0,0,0,0
D:0,2,2,2,2,2,2,2,2,2,2,2,2,2,0
D:0,2,0,3,3,3,3,3,3,3,3,3,0,2,0
D:0,2,2,0,0,0,0,0,0,0,0,0,2,2,0
D:0,2,0,0,0,3,0,0,0,3,0,0,0,2,0
D:0,2,0,0,0,0,0,3,0,0,0,0,0,2,0
D:0,2,0,3,0,0,0,2,0,0,0,3,0,2,0
D:0,2,0,0,0,0,0,2,0,0,0,0,0,2,0
D:0,2,0,0,0,2,0,3,0,2,0,0,0,2,0
D:0,2,0,0,0,0,0,2,0,0,0,0,0,2,0
D:0,2,0,3,0,0,0,2,0,0,0,3,0,2,0
D:0,2,0,0,0,0,0,3,0,0,0,0,0,2,0
D:0,2,0,0,0,3,0,0,0,3,0,0,0,2,0
D:0,2,2,0,0,0,0,0,0,0,0,0,2,2,0
D:0,2,0,3,3,3,3,3,3,3,3,3,0,2,0
D:0,2,2,2,2,2,2,2,2,2,2,2,2,2,0
D:0,0,0,0,0,0,0,0,0,0,0,0,0,0,0
C:3,8
H:11,8
