N:bcn02
T:200
S:15,17
D:3,0,0,0,0,0,0,0,0,0,0,0,0,0,3
D:0,0,0,0,0,0,0,3,0,0,0,0,0,0,0
D:0,0,0,2,2,2,2,0,2,2,2,2,0,0,0
D:0,0,0,3,0,0,0,0,0,0,0,3,0,0,0
D:0,0,2,0,0,0,0,3,0,0,0,0,2,0,0
D:0,0,2,0,3,0,0,3,0,0,3,0,2,0,0
D:0,0,2,0,0,0,0,0,0,0,0,0,2,0,0
D:0,0,2,0,0,0,0,3,0,0,0,0,2,0,0
D:0,3,0,0,3,0,3,3,3,0,3,0,0,3,0
D:0,0,2,0,0,0,0,3,0,0,0,0,2,0,0
D:0,0,2,0,0,0,0,0,0,0,0,0,2,0,0
D:0,0,2,0,3,0,0,3,0,0,3,0,2,0,0
D:0,0,2,0,0,0,0,3,0,0,0,0,2,0,0
D:0,0,0,3,0,0,0,0,0,0,0,3,0,0,0
D:0,0,0,2,2,2,2,0,2,2,2,2,0,0,0
D:0,0,0,0,0,0,0,3,0,0,0,0,0,0,0
D:3,0,0,0,0,0,0,0,0,0,0,0,0,0,3
C:13,2
H:1,14
